// mazeLevel, mazeComplex, monsterCount, monsterSpeed, starCount, potionCount, trapCount, superPotionCount, dragonCount, dragonSpeed

1  3 3 1200 1 1 1 1 0 700
2  3 5 1100 2 0 2 0 0 700
3  4 7 1000 3 1 3 0 0 700
4  4 9  900 4 0 4 1 0 700
5  4 11 800 5 1 4 1 0 700
6  4 13 700 6 1 4 1 1 600
7  4 15 600 5 1 4 1 1 500
8  4 17 500 6 1 5 1 1 400
9  4 19 500 7 1 5 2 2 400
10 4 20 500 8 1 6 2 3 400
